1111111111111111111111111111111111
100000000000000C00000C000F00000001
1010010100100000101001000000010001
1010010010101010001001000F000101E1
1P0000000C00C0001000000000000001C1
1111111111111111111111111111111111
