1111111111111111111111111111111111
1E0000000F00000C00000C0000F0000001
101001F100100000101001000000010101
1010010010101010001001000000010101
1P0000000C00C0000000000000F00000C1
1111111111111111111111111111111111
