1111111111111111111111111111111111
1E0000000000000C00000C0000F0000001
101001010010F000101001000000010101
1010010010101010001001000000010101
1P0000000C00C000000000F000000000C1
1111111111111111111111111111111111
